1111111111111111111111111111111111111111111111111111111111111111
1111111111111111111111111111111111111111111111111111111111111111
1111111111111111111111111111111111111111111111111111111111111111
1111111111111111111111111111111111111111111111111111111111111111
1111111111111111111111111111111111111111111111111111111111111111
1111111111111111111111111111111111111111111111111100111111111111
1111111111111111111111111111111111111111111111111100001111111111
1111111111111111111111111111111111111111111111110000000111111111
1111111111111111111111111111111111111111111111110000000011111111
1111111111111111000000111111111111111111111111110000000011111111
1111111111111111000000111110001111111111111111110000000011111111
1111111111110000000000010000001111100000011111100000000011111111
1111111111110000000000000000001111100000001111100000000011111111
1111111111000000000000000000001111100000001111100000000011111111
1111111110000000000000000111001011100100000111100000000011111111
1111111110000000000000000000000000000010000111100000000111111111
1111111110000000001100000000010000001001000111100000000111111111
1111111100000000111111001100100000000100000111100000000111111111
1111111100000001111111000100000000000100100011000000001111111111
1111111100000001111111101110001111110000100000000000001111111111
1111111100000001111111101110011111111100010000000000001111111111
1111111110000000111111111111001111111001000000000000001111111111
1111111110000000111111111110000000000000000000000000011111111111
1111111110000000011111111111000000000000000000000000111111111111
1111111100000000011111111111000000000000000000010011111111111111
1111111100000000001111111111000000011111111111111111111111111111
1111111111000000111111110000000111111111111111111111111111111111
1111111111110000111111111111111111111111111111111111111111111111
1111111111111111111111111111111111111111111111111111111111111111
1111111111111111111111111111111111111111111111111111111111111111
1111111111111111111111111111111111111111111111111111111111111111
1111111111111111111111111111111111111111111111111111111111111111