0000000000000000000000000000000000000000000000000001111110011111
0000000000000000000000000000000000000000000000000000000000000000
0000000000000000000000000000000000000000000000000000000000000000
0000000000000000000000000000000000000000000000000000000000000000
0000000000000000000000000000000000000000000000000000000000000000
0000000000000000000000000000000000000000000000000000000000000000
0000000000000000000000000000000000000000000000000000000000000000
0000011111111111111111111111111111111111111111111111111111110000
0111111111111111111111111111111111111111111111111111111111110000
1111111111111111111111111111111111111111111111111111111111111100
1111111111111111111111111111111111111111111111111111111111111100
1111111111111111111111111111111111111111111111111111111111111100
1111111111111111111111111111111111111111111111100000001111111100
1111111111111111111111111111111111111111111110000000000111111100
1111111111111111111111001110000111100001110000000000000011111100
1111111111100000000000000000000110000001000000000000000001111110
1111111111000000000000000000000000000000000000000000000001111110
1111111110000000000000000000000000000000000000011000010000111110
1111111100000000000111111111111100000000000111111111111010111110
1111111100000000001111111111111111100001111111111111111111111111
1111111111111111111111111111111111111111111111111111111111111111
1111111111111111111111111111111111111111111111111111111111111111
1111111111111111111111111111111111111111111111111111111111111111
1111111111111111111111111111111111111111111111111111111111111110
1111111111111111111111111111111111111111111111111111111111111110
1111111111111111111111111111111111111111111111111111111111111110
1111111111111111111111111111111111111111111111111111111110000000
1111111111111111111111111111111111111111111111111111111110000000
1011111111111111111111111111111111111111111111111111111110000000
0000000000000000000111111111111111110000000000000000000000000000
0000000000000000000000000000000000000000000000000000000000000000
0000000000000000000000000000000000000000000000000000000000000000