0000000000011111111111110000000000001111111110100001111111111111
0001111111100010000000001111111000001101001101111111111011111000
0000000000000001010011111000000000011100111010000000000000101000
0000000000000000001110001101000000010011010000000000000001001000
0000000000000000000000000000011110010000000000000000000001000100
0000000000000000000000000001001000101111000000000100000001101010
0000000000000000000000000010001010000001000000000100000000000110
0000000000000000000000001000011110101010000000001000000000000011
0000000000000000000000000000100000011011101000010000000000000000
0000000000000000000000001111010111011000010011000000000000000000
0000000000000000000010101101001100100000011001001010001010101110
0000000000000010010100100111100001111010000010000001010000000100
0000000000001100011110001110110010101100000000000001100000001000
0000000000010001001100000000000100101100001101000101100000100000
0000000000100000100010000000000000011100001000100111010100000000
0000000000000000000100000000000000100100110100000001000000000000
0000000000000000111000001001001101000000000000001000010000000000
0000000001010010010110000000001000000000100000000000000100000000
0000000001110101101001000010001000000000000000000000011000000000
0000000000000010000100000000000000000000100000000010100000000000
0000000001000010000100000000001000000000101001000010100000000000
0000000000110001011000000000000000000100101010010100000000000000
0000000000000000000000000000000010000000000001000000000000000000
0000000000000001000000000000001000100100001000000000000000000000
0000000000000000000100000100000000000000000000000000000000000000
0000000000000000000000000000000000000000000000000000000000000000
0000000000000000000000000000000000000000000000000000000000000000
0000000000000000000000000000000000000000000000000000000000000000
0000000000000000000000000000000000000000000000000000000000000000
0000000000000000000000000000000000000000000000000000000000000000
0000000000000000000000000000000000000000000000000000000000000000
0000000000000000000000000000000000000000000000000000000000000000